CODON	ANTICODON	AA
TTT	AAA	Phe
TTC	GAA	Phe
TTA	TAA	Leu
TTG	CAA	Leu
TCT	AGA	Ser
TCC	GGA	Ser
TCA	TGA	Ser
TCG	CGA	Ser
TAT	ATA	Tyr
TAC	GTA	Tyr
TAA	TTA	Stop
TAG	CTA	Stop
TGT	ACA	Cys
TGC	GCA	Cys
TGA	TCA	Stop
TGG	CCA	Trp
CTT	AAG	Leu
CTC	GAG	Leu
CTA	TAG	Leu
CTG	CAG	Leu
CCT	AGG	Pro
CCC	GGG	Pro
CCA	TGG	Pro
CCG	CGG	Pro
CAT	ATG	His
CAC	GTG	His
CAA	TTG	Gln
CAG	CTG	Gln
CGT	ACG	Arg
CGC	GCG	Arg
CGA	TCG	Arg
CGG	CCG	Arg
ATT	AAT	Ile
ATC	GAT	Ile
ATA	TAT	Ile
ATG	CAT	Met
ACT	AGT	Thr
ACC	GGT	Thr
ACA	TGT	Thr
ACG	CGT	Thr
AAT	ATT	Asn
AAC	GTT	Asn
AAA	TTT	Lys
AAG	CTT	Lys
AGT	ACT	Ser
AGC	GCT	Ser
AGA	TCT	Arg
AGG	CCT	Arg
GTT	AAC	Val
GTC	GAC	Val
GTA	TAC	Val
GTG	CAC	Val
GCT	AGC	Ala
GCC	GGC	Ala
GCA	TGC	Ala
GCG	CGC	Ala
GAT	ATC	Asp
GAC	GTC	Asp
GAA	TTC	Glu
GAG	CTC	Glu
GGT	ACC	Gly
GGC	GCC	Gly
GGA	TCC	Gly
GGG	CCC	Gly
